1111111111111111111111111111111111111111
100000000000000000000C11000000000001E001
1000000000000000000000000000000000000001
1011111111110000000000000000000000000001
1000000000000000000000000000000000000001
1000000000000000000000000000000000000001
1000000000000000000011111110000000000001
1000000000000000000000000000000000000001
1000000011111111000000000000000000000001
1000000000000000000000000000000000000001
100000000P000000000000000000000000000001
10000000000000000000000000000C0000000001
1000000000000000000000000000000000000001
1111111111111111111111111111111111111111