111111111111111
1C11110000000E1
100111010111111
1N0111100111111
110111001111111
1101110N1111111
110111001111111
1101111000C1111
110111101111111
110111101111111
100000000000001
1000000000000P1
111111111111111