1111111111111111111111111111111111111111
100000000N0000000000000000000010000E0001
1000000000000000000000000000001000000001
100C000011111100000000000000001N00000001
1000001100000011000000001111111000000001
110000110C00N011000000000000000011111111
111000110000000000000C000000000000000001
1111000011111100000000000000000000000001
111110000000000P0000000000000N0000000001
11111100N0000000000000000000011100000001
1111111000000001110000000000000000000001
1111111100000000000000001111111000011101
1111111110000N00000000000000001000000001
11111111110000000000000010N00C1000000001
11111111101000000000000011111110000N0001
1111111100010000000000000000000000000001
11111110000010000000000000N0000000000001
1111110C00000100000000C00000000000000001
1111100000000010000000000000000000000001
1111000000N00000000000000000000000000001
1111111111111111111111111111111111111111