/*==========================*/
/*          MAP             */
/*==========================*/
Wed Nov 23 08:34:41 2022
/*==========================*/
/*       BASICS FUNCT       */
/*==========================*/
