11111111111111111111111111111
1111100C000000P00100000011101
10000000111000000111110000001
10000000000000000100000000011
10000000000N00000100000000111
10000E00000000000100110000011
10000000001111110100000000001
10000000000000000000001100101
101111100000000N0000100000001
10000000000000000111111111111
10000111000000000000000000111
11111111111111111111111111111